{
    "room": [
        [0, 1, 1, 1, 1, 1, 1, 1, 1, 1, 17],
        [18, 31, 32, 32, 32, 32, 32, 32, 32, 34, 35],
        [18, 49, 50, 50, 50, 50, 50, 50, 50, 52, 35],
        [18, 67, 68, 68, 68, 68, 68, 68, 68, 70, 35],
        [18, 85, 86, 86, 86, 86, 86, 86, 86, 88, 35],
        [18, 103, 104, 104, 104, 104, 104, 104, 104, 106, 35],
        [18, 121, 122, 122, 122, 122, 122, 122, 122, 124, 35],
        [18, 121, 122, 122, 122, 122, 122, 122, 122, 124, 35],
        [18, 139, 140, 140, 140, 140, 140, 140, 140, 142, 35],
        [144, 157, 157, 157, 157, 157, 157, 157, 157, 157, 161]
    ],
    "furniture": {
        "bed": [
            [0, 7, 4],
            [1, 8, 4],
            [2, 9, 4],
            [16, 7, 5],
            [17, 8, 5],
            [18, 9, 5]
        ]
    }
}